11000000000001111111
11011111111101111111
11011111111101111111
11011111100001111111
11011111101111111111
11011000001111111111
11011011111111111111
11011011111111100011
11010011111111111011
11011011111111111011

