111111111111111111111
110000000000011111111
110111111111011111111
110111111111011111111
110111111000011111111
110111111011111111111
110110000011111111111
110110111111111111111
110110111111111111111
110100111111111111111
110110111111111111111
111111111111111111111
